1111111111111
1C010000000C1
1C00011111001
1P0011E000001
1111111111111